1111111111111111111111111111111111
1E10000000000000000000000000000001
1010010100100000101001000000010101
1010010010101010C01001000000010101
1P00000000000000000000000000000101
1111111111111111111111111111111111