11111111111111111111111111111111111
1E1M000000000000000000000000000M001
1M10010100100000101001M000001111111
101PC100101010100010010000000001011
1000000000000000000000000000M000011
11111111111111111111111111111111111